and	AQMJAgINAgIFBAIJAwcGAgIDBwYGBgcFBgQKCQYGAQcDAwIBBQIBAQcEAgUCCAICAQICAgQCAQICAQIDAgED
ndo	AWQE
dor	AT6TAQ==
orr	AX8=
rra	AX8YMw==
ra 	ASosPzU=
a p	ARwTDqkB
 pr	AYABCUc=
pri	ATZKCUc=
rin	ARxkCSwWAwIR
inc	AYABCUcc
nci	AYABCUc=
cip	AYABCUc=
ipa	AYABCQ==
pal	AYABCR4PAjM=
ali	AQxhEwEIBz0j
lit	AVMtBAU=
ity	AYABCQM5Jg==
ty 	AYABCQM5Jg==
y o	ASZaBQQDRg==
 of	AQIDAQECAgQBAgECAQEBAwECAQECAQMBAgICAQEBAQEBAwIBAQECAQEBAgEBAQECBAQBAwECAwIBAQIBAQICAQECAQEEAQECAQECAQECBAEBAQEBAQIBAQIBAQEBAQIBAgIBAQEDAQICAQEBAQEDAQECAQEBBAIBAQMCAQIBAQECAwEBAQEBAQEBAgIDAQICAQEBAgECAgEBAwIBAQIBAgEB
of 	AQIDAQECAgQBAgECAQEBAwECAQECAQMBAgICAQEBAQEBAwIBAQECAQEBAgEBAQECBAQBAwECAwIBAQIBAQICAQECAQEEAQECAQECAQECBAEBAQEBAQIBAQIBAQEBAQIBAgIBAQEDAQICAQEBAQEDAQECAQEBBAIBAQMCAQIBAQECAwEBAQEBAQEBAgIDAQICAQEBAgECAgEBAwIBAQIBAgEB
f a	AQIDAQECAgQuCHonAg==
 an	AQMECQ0vDQYYNAgTAggFAgoDCAY=
f t	AR8HAQIrHQUYBg0ECxMWAQICAQEBAws=
 th	ARsEBwECGQMPBQ4KBQ0LBg0ECwYJBBYSAQM=
the	ARkCAgIHAQIZCggFDgoFDQsGDQQLBgkEFBQBAwgB
he 	ARsEBwECGRIFDgoFDQsGDQQLBgkEKAED
e v	ATO4AQ==
 va	AT9HZQY=
val	AUWDARo=
all	AQRPO2Q=
lle	AR0MLzQUIg==
ley	AQ==
eys	AQ==
ys 	AQ==
s o	AUigAQc=
uni	AksqJh8DHQMGAwEH
nit	AkUGUEgDAQc=
ite	AiIpJBwQSAMBBw==
ted	AkcEUEgDAQc=
ed 	AkcEUEgDAQc=
d a	Ag1RFzQeDwo=
 ar	AgUDN0c5EyE=
ara	Aj8BBSIfHRUHEyE=
rab	Aj9HORMh
ab 	Aj9HTA==
b e	Ag==
 em	Ag==
emi	Am8=
mir	Ag==
ira	AmkB
rat	Ah0JAxMHBBYKEAUEEgQQFxIM
ate	AhsaDAYSDBQYCg8EBwQtAQMEBA==
tes	AkdUSwEH
es 	AhwoAwEDTgIUEhUCDgEH
s e	ApsB
afg	Aw==
fgh	Aw==
gha	A08=
han	AwICSwoe
ani	AwMBPQMqFBIYCQUo
nis	A1w1SgE=
ist	AzMpGQoSHhUUAw0G
sta	AwQWARQFDAYeAgsHAhYKEwIFBAwUAwoBAgEEBA==
tan	AwQaJiILCRoVBgYPFAMHBg==
an 	AwgFDgMIFB8MAQECAgMBAgYCAQsVDwYFCAUDAgMEBAcDBgcBAgI=
n i	A0obBBA2AwcGGhMB
 is	AwwRAgUGCRICEAYHAQQBDxMGAgQIBggBAwcGFAYEAwUHAQ==
isl	AwwRAgUGCRICEAYIBAEPEwYCBAgGCAEDBwYUBgQDBQcB
sla	AwwRAgUGCRICEAYMAQ8TBgIECAYIAQMHAgQUBgQDBQcB
lam	AxlQKxs=
ami	A2gBKwkS
mic	A0YjKxs=
ic 	AwMBAQICBAECAwIBBgQBBAEBAgIBAQEBAQEDAgEDAQEBAQQBAQUGAwECAQICAQMBAQIEAgEBAQUBAgMBAwEBAwECAgQDAQEBAQUCAQEBAwECAgEDAQQBAwEBBQEBBAIDAQICAgEBAQEBAQEBAgMBAwICAgECAQIDAQMDAQMCAQE=
c r	AwceFgcUExIZEQofDA==
 re	AwMBAQICBAECAwIBBgQBBAEBAgIBAQEBAQEDAQEBAwEBAQEEAQEEAQYDAQIBAgIBAQIBAQIEAgEBAQUBAgMBAwEBAwECAgQDAQEBAQIDAgEBAQMBAgIBAwEEAQMBAQUBAQICAgMBAgICAQEBAQEBAQECAwICAgICAQIBAgMBAwMBAwIBAQ==
rep	AwMBAQICBAECAwIBBgQBBAEBAgIBAQEBAQEDAQEBAwEBAQEEAQEEAQYDAQIBAgIBAwEBAgQCAQEBBQECAwEDAQEDAQICBAMBAQEBBQIBAQEDAQICAQMBBAEDAQEFAQEEAgMBAgICAQEBAQEBAQECAwICAgICAQIBAgMBAwMBAwIBAQ==
epu	AwMBAQICBAECAwIBBgQBBAEBAgIBAQEBAQEDAQEBAwEBAQEEAQEEAQYDAQIBAgIBAwEBAgQCAQEBBQECAwEDAQEDAQICBAMBAQEBBQIBAQEDAQICAQMBBAEDAQEFAQEEAgMBAgICAQEBAQEBAQECAwICAgICAQIBAgMBAwMBAwIBAQ==
pub	AwMBAQICBAECAwIBBgQBBAEBAgIBAQEBAQEDAQEBAwEBAQEEAQEEAQYDAQIBAgIBAwEBAgQCAQEBBQECAwEDAQEDAQICBAMBAQEBBQIBAQEDAQICAQMBBAEDAQEFAQEEAgMBAgICAQEBAQEBAQECAwICAgICAQIBAgMBAwMBAwIBAQ==
ubl	AwMBAQICBAECAwIBBgQBBAEBAgIBAQEBAQEDAQEBAwEBAQEEAQEEAQYDAQIBAgIBAwEBAgQCAQEBBQECAwEDAQEDAQICBAMBAQEBBQIBAQEDAQICAQMBBAEDAQEFAQEEAgMBAgICAQEBAQEBAQECAwICAgICAQIBAgMBAwMBAwIBAQ==
bli	AwMBAQICBAECAwIBBgQBBAEBAgIBAQEBAQEDAQEBAwEBAQEEAQEEAQYDAQIBAgIBAwEBAgQCAQEBBQECAwEDAQEDAQICBAMBAQEBBQIBAQEDAQICAQMBBAEDAQEFAQEEAgMBAgICAQEBAQEBAQECAwICAgICAQIBAgMBAwMBAwIBAQ==
lic	AwMBAQICBAECAwIBBgQBBAEBAgIBAQEBAQEDAQEBAwEBAQEEAQEEAQYDAQIBAgIBAwEBAgQCAQEBBQECAwEDAQEDAQICBAMBAQEBBQIBAQEDAQICAQMBBAEDAQEFAQEEAgMBAgICAQEBAQEBAQECAwICAgICAQEBAQIDAQMDAQMCAQE=
c o	AwMBAQICBAECAwIBBgQBBAICAgEBAQEBAQMCAQQBAQEEAQELAwECAwIBAwEBAgQCAQEGAwMBAwUBAgIEAwEBAQEFAgEBAQMBAgIBAwEEAQMBAQYBBAUBAgIDAQEBAQEBAQUEAgICAQIBAgMBAwMBAwIBAQ==
 af	AyZ3RxA=
ant	BAUViwEv
nti	BAYU
tig	BA==
igu	BJIB
gua	BFMEAToPFTA=
ua 	BKEBCw==
a a	BAYBAgQ0FYsBBA==
nd 	BAkCAg0NGwIFBwYGBgcFBg4gBQEHAQgEBwIIAgIBAgIIAwgG
d b	BElv
 ba	BA8EAwYxmQE=
bar	BA4IJokBHA==
arb	BAwC
rbu	BA==
bud	BA==
uda	BBd2Mww=
ang	BQMLZ2s=
ngu	BXU=
gui	BUsGAgUBUh8=
uil	BQ==
ill	BRkMlgE=
lla	BQhMTQ==
la 	BQM/FCVu
a m	BYYBBQMBAgFg
 ma	BRIwARwEIQQBAQEBAwEBAQIBAQEtAwc=
mal	BUMTMwMIAgECMA==
lli	BU+PARA=
lio	BcEB
iou	BZEB
ouh	BQ==
uha	BQ==
ana	BR4DFwoJAgwLLAELCwEi
alb	BsMB
lba	BsMB
ban	Bg1saw==
nia	BgEKLwQBASALFAsHCg4IAQULFgcB
ia 	BgEFAQQFBwcNBwYCBQEDBgUBBQgDAQMMAgkDAgIJAwQJAQMHBA4BAQIHAgQGCwYT
a r	BgEBAgIFBQ0OAQENEgMBAgMDBAMECgcJAgIEBQkHBQgQAQIIFwUDEAE=
 al	BgkIJzkSOw==
a s	BiUbPB4eCQECBAEF
 sh	BkQ=
shq	Bg==
hqi	Bg==
qip	Bg==
ipe	BssBEw==
per	Bg9XQg==
eri	BgUzBUAhISQH
ris	BjA8BiIt
ise	BkY=
arm	Bw==
rme	Bw==
men	Bz9OShc=
eni	BxJAbxY=
a h	BwZMBgoX
 ha	B1wOCQ==
hay	Bw==
aya	B7gB
yas	B5UB
ast	BwQhOXgN
ni 	B5ABPg==
i h	Bw==
anr	Bw==
nra	Bw==
rap	Bw==
ape	By0=
pet	Bw==
etu	B34=
tut	Bw==
ut'	Bw==
t'y	Bw==
'yu	Bw==
yun	Bw==
un 	B2s=
n h	Bz0t
ngo	CCACaQ==
gol	CIsBRg==
ola	CBNlMw==
nta	CXtUEg==
tar	CUpoHQ==
arc	Cc8B
rct	Cc8B
cti	CYQBSw==
tic	CR8WBzQFBCYpBwUP
ica	CQEBHgkKATMmBwMFQgIDBAc=
arg	Cg==
rge	Cp0B
gen	Cg==
ent	Ch+HAToDBw==
tin	CoMBCSEcAg==
ina	CgcECBMYFzUCORUC
na 	CgcEDg0gAgwBLQgBATEIFQI=
ine	ChE7AgVTAQYtAgc=
ne 	Co0BGgYUGw==
e r	ChUFCAIGGBMTDRULGQgGBQQKCBg=
ca 	CigKWlMO
ame	CySgARoH
mer	CyS6AQc=
ric	Cx4JaAYWMQIHBw==
can	CwUWAxRgED8E
n s	CyAXSxAPGQ4hAQ==
 sa	Cw8EJBgeFQctBgUFAQEh
sam	C+kB
amo	C3xt
moa	C+kB
oa 	Cyp2SQ==
 am	C94BBw==
a e	CzUDIgE=
 ea	C1p4DQ==
eas	C1pENA0=
ste	CwE2P1wNCg==
ter	CwEbGygpJCESCg==
ern	CzcLBBUvQxIKBAE=
rn 	CzcLSCAjEgoEAQ==
aus	DAE=
ust	DAERSw==
str	DAFSNQ==
tri	DDeEARs=
ria	DAooGh8MEg8wGg==
 au	DAE=
a o	DDtMVAM=
 os	DA==
ost	DCY3
err	DBtDBSkcAxQN
rre	DKgB
rei	DA==
eic	DA==
ich	DE4=
tra	DRwaHDU=
ral	DRwQDA5RBCY=
lia	DWElOw==
uss	DQ8ImwE=
ssi	DRcheg==
sie	Db4B
iel	DRc=
ela	DRcpGQc+DiMS
lan	DQIPAgIFBAIJAwcGAgIDBwYGBgcFCgYNBgYBBwMDAgYCAgcEAhECAQICAgQDBQcB
d n	DUArLg==
 no	DUBDBQwGBE0=
nov	DZ4B
ova	DX4gHw==
va 	DX4g
 ho	DRg6AkU=
hol	DZkBRg==
oll	DYABGQ==
ndi	DQs8EQQBGCk=
dia	DUcVAQshFQ==
a n	DRGDAQMHBUg=
 ne	DRFaLgIDBUI=
new	DZQBCgVC
ew 	DZQBCgUJOQ==
w h	DeUB
aru	Dg4IMw==
rub	Dg==
uba	DiU=
ala	Dw0rDQczDgINDg==
d i	DzkYDQ==
nds	Dw8CBwYbAhAGHBMGBgsLBA0UAgQEAwUHAQ==
ds 	Dw8JBhsCMhMGETAKCAcB
s a	Dw9aXhoD
 ah	Dw==
ahv	Dw==
hve	Dw==
ven	D7kBAiQ=
ena	Dz95Jg==
nan	D3A=
anm	Dyw/GA==
nma	DyxX
maa	D8QB
aze	EA==
zer	EBs=
erb	EK4B
rba	EAI=
bai	EEE=
aij	EJQB
ija	EHcdGgo=
jan	ELkB
n r	EAkQBg4xDz8DBQwLCQYBAwcDAQ==
 az	EA==
n a	ED07PAMNBA==
aza	ECVI
zar	EA==
bay	EA==
ayc	EA==
yca	EA==
bos	EQ==
osn	EQ==
sni	EQ==
d h	EVVa
 he	ERwsJ0cr
her	EQ0PICsdETIgAQ==
erz	EQ==
rze	EQ==
zeg	EQ==
ego	EQ==
gov	EQ==
ovi	Ea4B
vin	ETelAQ==
f b	EQIBAgEBAQMBAgICAQ==
 bo	EQwBBZMBBjI=
a b	EQ0GOgspXA==
ia-	EQ==
a-h	EQ==
-he	EQ==
erc	EQ==
rce	EQ==
ceg	EQ==
bad	Eg==
ado	Ei1eNQ==
dos	Elc0
os 	EhVQBx85
s b	EgwCBMsB
 bi	EhI=
bim	Eg==
ims	Eg==
msh	Eg==
shi	Eg==
hir	EnY=
ire	EgwKBCEZ
ngl	Ezo=
gla	Ezo=
lad	E0Y=
ade	E0Q=
des	E60BMgYB
esh	Ew==
sh 	ExI5CwGFAQ==
h p	E3oiJA==
 pe	EwkUDi4NBTALLg==
peo	Ex0OOwU=
eop	Ex0OOwU=
opl	Ex0OOwU=
ple	Ex0OOwUr
le'	Ex0OOwU=
e's	Ex0OOwU=
's 	Ex0OOwU=
s r	ExEMByoYFgsBFhI=
h b	Ew==
bel	FBABlAE=
elg	FA==
lgi	FA==
giu	FA==
ium	FA==
um 	FA==
m k	FA==
 ki	FAMKGgkJJAMBAQIMBR0BGgQQBQY=
kin	FAECCgcTCQkkBA8FHQEaBBAFBg==
ing	FAMKBhQJCSQBAwUKBR0BGgQBDwUGCA==
ngd	FAMKGgkJJAQPBR0BGgQQBQY=
gdo	FAMKGgkJJAQPBR0BGgQQBQY=
dom	FAMKGgEBBwkkBA8FHQEaBBAFBg==
om 	FAMKGgkJJAQPBR0BGgQQBQY=
m o	FAMKGgkJJAQPBR0BGgQQBQY=
 be	FAULlQE=
m b	FAg=
giq	FA==
iqu	FIIBCRUC
que	FIIBCRUC
ue 	FIIBCQs=
e b	FAoCBQ==
gie	FA==
bur	FQNuDA==
urk	FcEBCAM=
rki	FcwB
a f	FTACAlsLEA8S
 fa	FTMC
fas	FQ==
aso	FQ==
so 	FcAB
o u	FYgB
 up	FQ==
upp	FQ==
ppe	FQ==
er 	FTUuGw8=
r v	FQ==
 vo	FQ==
vol	FQ==
olt	FQ==
lta	FTENRhM=
bul	FiY=
ulg	Fg==
lga	Fg==
gar	Fk5i
ari	FggiVQE2Ig==
 bu	FgJ6
bah	Fwk=
ahr	Fw==
hra	Fw==
rai	F88B
ain	FwMEJgkrCAQJJxMMEwc=
in 	FwIrCRsZAwlGHAE=
n k	FwojMBBB
n m	F2MbFx0D
mam	Fw==
aml	Fw==
mla	Fw==
lak	Fy8=
aka	Fw==
kat	Fw==
at 	FzYHFUM=
t a	FypfDEE=
al-	F2ASOw==
l-b	Fw==
-ba	Fw==
ray	Fw==
ayn	Fw==
yn 	Fw==
n d	FwIIpgEM
 da	FwIDHz9N
daw	Fw==
awl	Fw==
wla	Fw==
lat	F3A=
uru	GH8SQQ==
run	GAQ=
und	GA==
di 	GKkB
i r	GCINHBMbCzI=
i u	GNgB
 ub	GA==
ubu	GCQ=
ben	GQ==
nin	GU8u
dah	GQ==
aho	GQ==
hom	GQ==
ome	GS1OPQ==
mey	GQ==
sai	GgRaCA0nEwwa
int	GgRaCA0nEwwa
nt 	GgRaCA0cBwQTDBoH
t b	GjM=
art	GnMJPQ==
rth	GjMsFwVj
hel	Gj9qBA==
ele	Gp8BDg==
lem	Gg==
emy	Gg==
my 	Gg==
y s	GtIB
 st	GgMaDAYeFBIGChMHBC0BAwQE
st.	GnM=
t. 	GnM=
. b	Gg==
ths	Gg==
hs 	Gg==
s s	GhEfLmI=
th 	GgYcHh8BFgULMCUC
h s	GkA3PwMF
rts	Gg==
ts 	Gl4=
ber	G0sd
erm	Gx4=
rmu	Gw==
mud	Gw==
da 	Gz5nByAD
a v	Gw==
 vi	GyymAQIBAQ==
vir	G9QBAQ==
irg	G1l7AQ==
rgi	GzQLlQEB
gin	G9QBAQ==
neo	Gw==
eol	Gw==
bru	HA==
une	HG4=
nei	HA==
ei 	HA==
i d	HA==
dar	HA==
rus	HAgTiAE=
ssa	HEE=
sal	HIABNg==
am 	HEBzIg==
 br	HAMGKBGRAQ==
i n	HIAB
 na	HIQBBAVI
nat	HAGPAQ==
ati	HAEBAQkDEwcaAxQDBQQSAhIXEgQIDw==
tio	HAEOlAE=
ion	HAEONBgdKAMHARU=
on 	HA8EHRMTBQIGFSgDAwQBFQ==
n o	HEMLDR0=
ei,	HA==
i, 	HA==
, t	HA==
e a	HJgBHQ==
 ab	HCk=
abo	HBgY
bod	HFk=
ode	HNwBAQ==
de 	HBhZ
e o	HAEmJAETMQQHBDk=
f p	HJEBAQICAQQCAQ==
pea	HMsB
eac	HA==
ace	HHQ=
bol	HdEB
oli	HXZb
liv	HdEB
ivi	HXA=
via	HWoEMw==
 pl	HYwB
plu	HQ==
lur	HQ==
uri	HVogAzU=
ona	HQEuCgoq
nal	HUNN
al 	HQwQDBMHNRAEBQsVAR4=
l s	HUosOgUa
tat	HQEZDAYeFBgKEwcELQEDBAQ=
te 	HQcIFyQKChIfBAcEIg8I
bon	Hi5w
nai	Hi5Y
air	HgqNAQ==
re,	Hg==
e, 	Hg==
, s	Hg==
 si	HqgBBQgH
sin	HictVA0=
t e	Hg==
 eu	Hg==
eus	Hg==
tiu	Hnw=
ius	Hnw=
us 	HgYTY1Y=
d s	Hg0bAwSGAQITAQc=
sab	Hg==
aba	HiJH
ba 	HhU=
net	HogB
eth	Hidh
erl	Hg17
rla	Hg17
til	Hg==
les	Hi83MwwWAQM=
s d	HiBA
 du	HmhJBA==
dut	HrEBBA==
utc	HrEBBA==
tch	HrEBBA==
ch 	HhoTBQozBB4gBAU=
h a	HtcBAg==
s c	HgIHBAJPGQ==
 ca	HhEFQQclDCk=
car	HnAX
arr	Hg==
rri	HglDBUgYCQ==
rib	HlgT
ibe	Hkgd
bea	Hg==
ean	HkxF
n n	HlQ=
re 	HgoEiAES
a c	HgoJBAMEOTgaHQ==
ibb	Hg==
bbe	Hg==
bra	Hwsp
raz	HwsL
azi	H7YB
zil	H7YB
il 	Hw==
l f	H4kB
 fe	HxoMBFsEFw8=
fed	HwwODARbBBcP
ede	HwwODARbAgIXBgk=
der	HwwODARbAgIXDw==
era	HwwODAQOPw4EFw8=
tiv	H0AuBw==
ive	H0A1Bw==
ve 	H0A1Bw==
l b	Hw==
ras	HwYQLA==
asi	Hw==
sil	Hw==
aha	ICIa
ham	IA==
ama	IFAHESU=
mas	IBY=
as 	IBYSGQ==
 co	IAcBAgEBAQQBCjsWCD4=
com	IBw7Hg==
omm	IBxZ
mmo	IBxZ
mon	IBxOAgcCAyo=
onw	IBxZ
nwe	IBxZ
wea	IBxZ
eal	IBxZFg==
alt	IBwKDUIE
lth	IBxZ
h o	IBxZGg==
s t	IAevAQo=
ma 	IFcbGw==
a i	ICMmFxUCGTAU
bhu	IQ==
hut	IQ==
uta	IXY=
 bh	IUg=
 dr	IQc=
dru	IQ==
ruk	ITY=
uk 	ISwt
k y	IQ==
 yu	IZ0B
yul	IQ==
bou	IhhMNg==
ouv	In8=
uve	In8=
vet	Ig==
et 	Ip0BMg==
t i	IkNE
bot	Iw==
ots	Iw==
tsw	Iw==
swa	I7IB
wan	I11AJA==
lar	JA==
 by	JA==
bye	JA==
yel	JA==
elo	JDNd
lor	JA==
oru	JA==
sia	JCUcBzIREBsFGQE=
ss 	JAc=
bie	JA==
a w	JBg7fQ==
 wh	JA==
whi	JA==
hit	JA==
 ru	JJkBAg==
eli	JQI=
liz	JQ==
ize	JQ==
ze 	JQ==
bri	JSgRDIUBAw==
rit	JQIcChEMLAEDHSEX
iti	JSIXBQcsBFU=
tis	JTkMhQE=
ish	JTkMhQE=
h h	JUQ=
hon	JQsvAhE=
ond	JTw=
ndu	JTwI
dur	JTw=
ura	JRAs
nad	JiifAQ==
ada	JigJAjU=
coc	Jw==
oco	Jw==
cos	JwukAQ==
s (	JyE=
 (k	JwE=
(ke	Jw==
kee	Jw==
eel	J4QB
lin	Jw==
ng)	Jw==
g) 	Jw==
) i	Jw==
 te	J0NNIQ==
ito	J0NNIQ==
tor	JzESTSE=
ory	JwU+TQ==
ry 	JwU4bw==
e c	JwECAghD
s k	J1Eu
 ke	J0w=
ng 	JzgTdg==
g i	J8EB
s i	Jw8SjgE=
dem	KBYHNAUEJikM
emo	KBYHNAUEJikM
moc	KBYHNAUEHQkpDA==
ocr	KBYHNAUEJikM
cra	KBYHNAUEJikM
con	KAIBKw==
ong	KAIGLzRN
go 	KAKvAQk=
o d	KA==
drc	KA==
rc 	KA==
c c	KAEB
go-	KAI=
o-k	KA==
-ki	KA==
ins	KA==
nsh	KA==
sha	KGc=
has	KEk=
asa	KA0RVg0=
sa 	KLwB
a d	KFEBCA==
dr 	KA==
r c	KA==
o z	KAg=
 za	KL0BEw==
zai	KA==
e d	KARhRAw=
o c	KAILVw==
o (	KAI=
(ki	KA==
sa)	KA==
a) 	KA==
) z	KA==
cen	KZ4BJg==
ntr	KSaEAQ==
l a	KTY1
afr	KXdHEA==
fri	KXdABxA=
 ce	KVk=
o r	KowBFhY=
o-b	Kg==
-br	Kg==
azz	Kg==
zza	Kg==
zav	Kg==
avi	KmEz
vil	Kg==
le 	KgQ6
 (b	Kg==
(br	Kg==
le)	Kg==
swi	Kw==
wit	Kw==
itz	Kw==
tze	Kw==
 sw	K5oBEA==
wis	Kw==
iss	KzI=
onf	Kw==
nfe	Kw==
 su	KxssHxsYCwEE
sui	Kw==
uis	Kw==
sse	Kw==
se 	KyEzOQgZCw==
e s	KxgXMyoNCwIo
 sc	KyI=
sch	Kw4=
chw	Kw==
hwe	Kw==
wei	Kw==
eiz	Kw==
iz 	Kw==
z s	Kw==
 sv	K5oB
svi	K8UB
viz	Kw==
izz	Kw==
zze	Kw==
izr	Kw==
zra	Kw==
cot	LCE=
ote	LH8=
 d'	LA==
d'i	LA==
'iv	LA==
ivo	LA==
voi	LA==
oir	LA==
f c	LAIBAQEBAQEDKAMTH0MN
e i	LB4eLgUWMg==
 iv	LA==
vor	LA==
y c	LA==
coa	LAk=
oas	LA==
st 	LDkdCxM9FA==
t c	LEw=
te-	LA==
e-d	LA==
-d'	LA==
d'l	LA==
'lv	LA==
lvo	LA==
coo	LQ==
ook	LQ==
ok 	LQ==
k i	LXY=
s h	LXk=
erv	LQ==
rve	LQ==
vey	LQ==
ey 	LSQe
y i	LUFy
k g	LQ==
 gr	LQoWBzJn
gro	LSc4
rou	LZAB
oup	LSo=
chi	LgIIJxYfUA==
hil	LoMBDw==
ile	LqwB
 ch	LgIvGQEBGkMN
cam	L0Yq
ero	L3o=
roo	Lw==
oon	Lw==
hin	MC8KK1A=
a z	MHs=
 zh	MA==
zho	MA==
ngg	MA==
ggu	MA==
guo	MA==
uo 	MA==
col	MVw=
olo	MZEB
lom	MZEB
omb	MQ==
mbi	MSRKWQ==
bia	MSRLHgM0Aw==
ta 	MhQjMA==
 ri	MkBE
cub	Mw==
 cu	MwKSAQ==
cab	NA==
bo 	NA==
o v	NBNA
 ve	NLoB
ver	NJEB
erd	NA==
rde	ND1V
cap	NA==
pe 	NCN6
cur	NQ==
rac	NQ==
aca	NV8C
cao	NV8=
ao 	NUkWPQ==
o k	NU8F
 ko	NSoYAgE=
kor	NUQB
ors	NS8=
rso	NQ==
sou	NSUgJjAIHQIC
ou 	NQ==
u c	NQ==
uro	NQ==
roc	NVRb
oca	NWo=
sao	NZwB
zao	NQ==
aco	NVU=
cau	NV8=
au 	NSg3JSM=
chr	NkI=
hri	NkI=
stm	Ng==
tma	Ng==
cyp	Nw==
ypr	Nw==
pru	Nw==
 cy	Nw==
s g	Nw==
gre	NxYBBgWUAQ==
ree	Nx0F
eek	Nw==
ek 	Nw==
k c	N0M=
rio	Nw==
iot	Nw==
ot 	Nw==
t s	N0Q1RA==
cze	OA==
zec	OA==
ech	OEk=
hia	OD0=
 cz	OA==
h r	OBM=
ger	OQVkAg==
rma	OVk=
man	OS8UMBE=
any	OV5O
ny 	OQ==
y f	OQ==
l r	OWspAQ==
f g	ORQEAQQFAgE=
 ge	ORYL
y d	OQ==
 de	OQIDBzQFBAsbKQw=
deu	OQ==
eut	OQ==
uts	OQ==
tsc	OQ==
chl	OQ==
hla	OQ==
dji	Og==
jib	Og==
ibo	Og==
out	OiAgGQ0wCBANAgI=
uti	Og==
ti 	OgYHHBM=
f d	OgEB
 dj	Og==
i j	OjU=
 ji	Og==
ibu	Og==
but	Og==
i g	Og0=
 ga	Og0FCRQuLw==
gab	OhI=
abu	Og==
buu	Og==
uut	Og==
 ja	Ok5B
jab	Og==
den	OzY1ChUBLg==
enm	Ow==
mar	OzwSBAIDAwE2Bw==
ark	Ow==
rk 	Oz4=
k k	Ow==
k d	Oz8=
dan	OzYgMww=
omi	PAEJ
min	PAEiGxpU
ini	PAEIGjUCIR4NBA==
nic	PAEcPQ8=
 do	PAE=
 wa	PBEq
wai	PD8=
ai'	PA==
i't	PA==
'tu	PA==
tu 	PAurAQ==
u k	PA==
 ku	PD8=
kub	PA==
uli	PA==
li 	PFU9
i w	PDs=
c d	PQ==
alg	Pg==
lge	Pg==
ecu	Pw==
cua	Pw==
uad	Pxg=
or 	P5MBCws=
r r	P08EEB0T
f e	PwEBAgITegM=
 ec	Pw==
est	QAJbAxcmFw==
sto	QDg=
ton	QKAB
oni	QFAR
 es	QF04
 ee	QA==
ees	QA==
sti	QHc=
i v	QA==
vab	QEc=
rii	QA==
iik	QA==
ik 	QA==
k e	QA0=
stl	QA==
tla	QA0=
egy	QQ==
gyp	QQ==
ypt	QQ==
pt 	QQ==
b r	QZMB
 eg	QQ==
t m	QUxG
 mi	QQgxOjQ=
mis	QQ==
isr	QSY=
wes	Ql41Hw==
sah	Qg==
har	Qic=
itr	Qw==
tre	Qw==
rea	QwosAQ==
ea 	QxMCHQQBNg==
a t	QwMPayU=
 er	Qw==
 ir	QwoeAQ==
iri	QzMS
riy	Q0U=
iya	Q0U3
ya 	QwQiCgITDyg=
ert	Q3M=
rtr	Qw==
spa	RA==
pai	RA==
f s	RD4LMQMCAgECAwEBAQEBAQIHGgM=
 sp	RBs1
 hi	RCIDVw==
his	RA==
isp	RA==
pan	RC47
thi	RQ==
hio	RQ==
iop	RQ==
opi	RQ==
pia	RQ==
l d	RWM=
 et	RQ==
aby	RQ==
bys	RQ==
yss	RQ==
fin	Rg==
inl	Rg==
nla	Rg4=
d r	RidGCRsO
f f	RgE=
 fi	RgE=
suo	Rg==
uom	Rg==
en 	Ris1EA8BDSI=
n t	RiICPBEhBgY=
 ta	RpUBCQE=
tas	Rg==
sav	Rg==
ava	Rg==
a l	Rj8CAUM=
 la	RiwMBAU5EwUC
d o	Riw6FBo=
 a 	Rno=
tho	Rj48
hou	Rno=
ous	Rno=
usa	Rno=
san	RhRPFww=
d l	RpQB
ake	Rg==
kes	Rg==
s f	RgICjgE=
inn	Rg==
nni	RiI=
fij	Rw==
iji	Rw==
ji 	Rw==
i m	R1A=
mat	R08=
ata	RyJS
itu	Rw==
u t	Rw==
 tu	R48BCAEC
tug	R3E=
uga	R3Ev
gal	R3EV
lal	Rw==
 o 	Rw==
vit	R0Y=
i f	R0o=
gan	RyIuTgI=
nar	RyI=
raj	RyI=
ajy	RyI=
jya	RyI=
fal	SA==
alk	SA==
lkl	SA==
kla	SA==
 (m	SA==
(ma	SA==
alv	SIoB
lvi	SA==
nas	SE0=
as)	SA==
s) 	SA==
) m	SA==
las	SBE=
s m	SFIBAks=
icr	SQ==
cro	SRk=
ron	SQ==
one	SQMZSB4=
nes	SQMZGjACMwk=
esi	SRxKSQE=
f m	SR8hAQEDAwEFAgEBAQM=
far	Sg==
aro	SholIg==
roe	Sgo=
oe 	Sg==
fae	Sg==
aer	Skw=
r o	Sp4B
 oe	Sg==
oer	Sl8=
r f	Sg==
oes	Sg==
she	Sic=
hee	Sg==
eep	Sg==
ep 	Sg==
p i	Sg==
fra	S0I=
ran	SyEaBw==
anc	S0I=
nce	S0Jg
ce 	Sw6KAQ==
e f	Sw==
 fr	S0YeKQg=
fre	SwU9BB4p
ren	SwMCMgsEHikV
enc	SwU9BB4p
nch	SwU9BB4p
n g	TAEPFQ==
ese	TDM5CBkL
c g	TA==
ais	TA==
d k	TY0B
m u	TQ==
 un	TSomIh0JBAc=
eat	TQ==
ita	TSEpIQ==
tai	TTdg
nor	TSwHEAUOBEEQ
ort	TSwXBSECQA==
rel	TRk=
d g	TQc=
n b	TRxN
n u	TV8T
 uk	TZkB
 en	TQ==
eng	TQ==
sco	TQ==
otl	TQ==
d w	TQ==
wal	TaYB
ale	TVQW
s n	TUg=
n e	TQ==
geo	Tws=
eor	Tws=
org	TwtN
gia	Tws=
a g	TwEGATUL
a (	Tw==
 (c	Tw==
(co	Tw==
cou	T4QB
oun	TzUSPQ==
unt	TzVP
try	T4QB
ry)	Tw==
h g	UAoEcQ==
 gu	UAEFAgMBAQFSHw==
uia	UA5x
ian	UA4MBCcBIQgQBRo=
guy	UA4=
uya	UA4=
yan	UA4qCg==
ane	UC8Y
gue	UWc=
uer	UWU=
rns	UQ==
nse	UQ==
sey	UR5U
y b	UZkB
ail	UYkB
ili	UWA=
liw	UQ==
iwi	UQ==
wic	UQk=
ick	UQ==
ck 	UQ==
k o	UQ==
 gh	Ug==
gib	Uw==
ibr	Uw==
een	VA==
enl	VA==
a k	VCECSh8=
 ka	VAMeCCQ=
kal	VA==
laa	VA==
aal	VA==
it 	VCc=
t n	VJ0B
 nu	VA==
nun	VA==
una	VEJd
naa	VEM=
aat	VA==
t g	VBU=
oen	VA==
gam	VQ==
amb	VSAqWQ==
e g	VZgB
uin	VgIFUw==
nea	VgIFUw==
ea-	Vgc=
a-c	Vg==
-co	Vg==
nak	Vks=
akr	Vg==
kry	Vg==
del	Vw==
lou	Vw==
upe	Vw==
e k	Vxow
kar	Vzc=
uke	Vw==
ker	Vw==
 gw	Vw==
gwa	Vw==
wad	Vw==
adl	Vw==
dlo	Vw==
up 	Vw==
p g	Vw==
equ	WA==
qua	WA==
uat	WAOXAQ==
ato	WA==
ori	WB8gAxwiEg==
ial	WAcjEl0=
l g	WA==
 eq	WA==
eec	WQ==
ece	WQ==
e h	WQ==
ell	WUgiIA==
len	WW4=
c e	WQ==
 el	WXkR
uth	WiAmMAgdAgI=
d t	Wm0bCw==
 so	WigeHw8CCBkEAgI=
ndw	Wg==
dwi	Wg==
h i	WhA=
tem	Ww==
ema	Ww==
uam	XA==
m g	XA==
uah	XA==
a-b	XQ==
-bi	XQ==
bis	XQ==
sau	XWQ=
u r	XUwFCzk=
g k	Xw==
kon	Xw==
g h	Xw==
g s	XxM=
spe	XzU=
pec	XzU=
eci	XzU=
cia	XyECEl0=
 ad	XzU=
adm	XzU=
dmi	XzU=
reg	XzU=
egi	XzU=
gio	XxIj
 hk	Xw==
hks	Xw==
ksa	Xw==
sar	XzU=
hea	YBU=
ear	YEs8
ard	YBFVAw==
rd 	YGk=
d m	YD0X
 mc	YA==
mcd	YA==
cdo	YA==
don	YAUrEQ==
ald	YDs=
ld 	YA==
f h	YQI=
roa	Ykk=
oat	Yg==
tia	Yg==
 cr	Yio=
hai	Y3c=
ait	Yxg=
i a	Y14=
 ay	Yw==
ayi	Yw==
yit	Yw==
hun	ZA==
ung	ZA==
nga	ZGIaBQ==
ary	ZA==
y h	ZA==
 hu	ZA==
y m	ZA==
mag	ZCU=
agy	ZA==
gya	ZA==
yar	ZA0=
ror	ZA==
rsz	ZA==
sza	ZA==
zag	ZA==
ind	ZQQBRkQ=
f i	ZQICAgEB
 in	ZQQBRkQ=
die	ZQ==
ies	ZXM=
hib	Zg==
rni	Zg==
 ei	Zg==
eir	Zg==
sra	Zw==
rae	Zw==
ael	Zw==
el 	Z2s=
sle	aA==
ann	aC8=
nn 	aA==
 i.	aA==
i. 	aA==
. m	aCU=
 m.	aA==
m. 	aA==
anx	aA==
nx 	aA==
x m	aA==
bha	aQ==
atv	aR4=
tva	aQ==
var	aYUB
ars	aSY=
rsh	aSY=
doo	aQ==
oos	aQ==
dus	aQ==
 oc	akU=
oce	akU=
cea	akU=
raq	aw==
aq 	aw==
q r	aw==
q m	aw==
 me	azI=
mes	aw==
eso	axk=
sop	aw==
opo	aw==
pot	aw==
ota	aw==
tam	aw==
mia	aw==
n p	bBU0AQ==
ers	bAM=
rsi	bA==
ice	bS1J
cel	bQ==
 ic	bQ==
d y	bQ==
 ys	bQ==
ysl	bQ==
tal	bnw=
aly	bg==
ly 	bnIM
 it	bg==
c i	bg==
jer	bw==
rse	bw==
y j	bw==
 je	bw==
ri 	bwgL
i i	byc=
 ie	bw==
ier	b0UX
jam	cBg=
mai	cA==
aic	cGY=
jor	cQ==
ord	cQ==
rda	cQ==
ash	cQ==
hem	cQ==
mit	cQ==
f j	cQ==
 jo	cQgd
n y	cQ==
 ya	cQ==
 gi	cQ==
ior	cQ==
jap	cg==
apa	cno=
n l	cg1U
isi	cm0=
sun	cg==
 ni	cjACAQU=
nip	cg==
ipp	cj8=
ppo	cg==
pon	cg==
on-	cg==
n-k	cg==
-ko	cg==
kok	cg==
oku	cg==
ku 	cg==
u n	cjdJ
nih	cg==
iho	cg==
ken	c0M=
eny	cw==
nya	cyQF
f k	cwMDAQEC
kyr	dA==
yrg	dA==
rgy	dA==
gyz	dA==
yzs	dA==
zst	dA==
 ky	dA==
yz 	dA==
z r	dA==
c k	dA==
z k	dA==
kir	dAI=
rgh	dA==
ghi	dA==
hiz	dA==
izi	dA==
zia	dA==
mbo	dRE=
odi	dQ==
kam	dQ==
amp	dQ==
mpu	dQ==
puc	dQ==
uch	dRE=
che	dU4=
odz	dQ==
dzh	dQ==
zha	dQ==
ha 	dQ==
boy	dQ==
oya	dQ==
boj	dQ==
oja	dQ==
iba	dm8=
bat	dg==
omo	d0s=
mor	dxIOA0M=
oro	dxI=
ros	d0g=
s u	dyZLAQc=
nio	d0UDHQ==
 ud	dw==
udz	dw==
dzi	dw==
zim	d4IB
ima	dw==
wa 	dw==
kom	dw==
wak	dw==
aku	dw==
ku-	dw==
u-m	dw==
-mo	dw==
a j	dx8=
 ju	dw==
juz	dw==
uzu	dw==
zur	dw==
ur 	dw==
r a	dwEcAw==
l-q	dw==
-qu	dw==
qum	dw==
umu	dw==
mur	dyA=
r j	dw==
-qa	dw==
qam	dw==
ar 	dxcEAgMk
l-i	dw==
-it	dw==
itt	dwE=
tti	dw==
tih	dw==
iha	dw==
had	d2A=
ad 	d2AL
t k	eA==
kit	eA==
tts	eA==
nev	eA==
evi	eA==
vis	eA==
is 	eCJZ
top	eA==
oph	eA==
phe	eA==
s &	eA==
 & 	eA==
& n	eA==
h k	eQE=
ore	eQFM
c p	eQ==
 dp	eQ==
dpr	eQ==
prk	eQ==
k j	eQ==
jos	eQ==
ose	eQ==
seo	eQ==
eon	eVI=
n c	eRQ5DRk=
cho	eQE=
hos	eQE=
oso	eQE=
son	eQE=
dae	eg==
aeh	eg==
eha	eg==
nmi	eg==
guk	eg==
k h	eg==
kuw	ew==
uwa	ew==
cay	fA==
aym	fA==
yma	fA==
ans	fHs=
kaz	fQ==
zak	fQ==
akh	fQ==
khs	fQ==
hst	fQ==
n q	fQ==
 qa	fT4=
qaz	fQ==
zaq	fQ==
aqs	fQ==
qst	fQ==
lao	fg==
aos	fg==
s l	fg==
o p	fgwf
c l	fgEKLyA=
 lp	fg==
lpd	fg==
pdr	fg==
leb	fw==
eba	fw==
ano	fwEd
non	fw==
 le	fwUDRBI=
 lu	fwEGMg==
lub	fw==
ubn	fw==
bna	fw==
t l	gAE=
luc	gAE=
uci	gAE=
 iy	gAE=
iyo	gAE=
yon	gAE=
ono	gAE=
nol	gAE=
hew	gAE=
ewa	gAE=
lie	gQEE
iec	gQE=
cht	gQE=
hte	gQE=
ten	gQELRw==
ens	gQFGAw==
nst	gQE=
tei	gQE=
ein	gQE=
f l	gQECAQEBAQ==
 li	gQECAgM+
sri	ggE=
i l	ggE=
ank	ggE=
nka	ggE=
ka 	ggFj
c s	ggFICg==
soc	ggFv
oci	ggFv
lis	ggFvAg==
t r	ggFv
 sr	ggE8
 se	ggE8BQof
ser	ggEWJg==
ere	ggE=
end	ggEuMBQ=
dib	ggE=
ib 	ggEH
b c	ggE=
cey	ggE=
eyl	ggE=
ylo	ggE=
lon	ggEy
lib	gwEF
sot	hAE=
oth	hAE=
ho 	hAE=
o t	hAFNCA==
e m	hAELCAg=
 mo	hAEFAQEBBwQDBQ==
mou	hAE=
ith	hQE=
thu	hQE=
hua	hQE=
uan	hQERTg==
iet	hQE6Mg==
tuv	hQFe
uva	hQFe
lux	hgE=
uxe	hgE=
xem	hgE=
emb	hgE=
our	hgE2
urg	hgE=
rg 	hgE=
g g	hgE=
gra	hgE=
d d	hgE=
duc	hgE=
chy	hgE=
hy 	hgE=
g l	hgE=
mbu	hgFP
tvi	hwE=
let	hwE=
etm	hwE=
tmo	hwE=
mo 	hwE=
bam	hwE=
o l	hwE=
vij	hwE=
ja 	hwE3
tve	hwE=
vej	hwE=
eja	hwE=
iby	iAE=
bya	iAE=
b j	iAE=
mah	iAE=
ahi	iAE=
occ	iQE=
cco	iQE=
co 	iQEBExk=
o m	iQEBAggC
oc 	iQFb
 lm	iQE=
lma	iQE=
agr	iQE=
gri	iQE=
b a	iQE=
l-m	iQE=
-ma	iQEE
nac	igEM
 mu	igENFQ==
mun	igE=
neg	igECQQ==
egu	igE=
mol	iwE=
old	iwE=
ldo	iwE=
dov	iwE=
lda	iwE=
dav	iwE=
ont	jAEM
nte	jAE=
ene	jAFBIQ==
egr	jAE=
ro 	jAEd
crn	jAE=
rna	jAE=
 go	jAE=
gor	jAE=
ora	jAE=
nt-	jQE=
t-m	jQE=
rti	jQEJPQ==
lec	jQE=
ect	jQE=
n (	jQFG
 (f	jQE=
(fr	jQE=
 pa	jQEgAwIFAgEZGQ==
par	jQEtGQ==
rt)	jQFG
t) 	jQFG
) s	jQFG
ce)	jQE=
e) 	jQE=
mad	jgEI
dag	jgE=
aga	jgEJ
gas	jgE=
asc	jgE5
sca	jgEe
r m	jgEFAQ==
lag	jgE=
ask	jgE=
ska	jgElDA==
asy	jgE=
sy 	jgE=
y r	jgEs
hal	jwE=
ll 	jwE=
l i	jwE=
h m	kAE=
mac	kAEE
ced	kAE=
edo	kAER
f n	kAEQBAECAQE=
sud	kQEzDA==
mya	kgE=
 my	kgE=
r b	kgE=
urm	kgE=
 ou	kwFUAQ==
ute	kwE=
ol 	kwE=
o s	lAE=
u m	lAE=
u s	lAE=
 ao	lAEX
aom	lAE=
e n	lQENBAQ=
niq	lgE=
 ig	lgE=
cae	lgE=
ino	lgE2HA==
no 	lgE2
adi	lgFX
din	lgFX
jou	lgE=
oua	lgE=
nik	lgE=
iki	lgFF
ki 	lgE=
 io	lgE=
mau	lwED
aur	lwEDDw==
rut	lwE=
taa	lwE=
aan	lwE=
ure	lwE=
ret	lwE=
eta	lwE=
nna	lwE=
aar	lwE8
r g	lwE=
 ag	lwE=
gaw	lwE=
awe	lwE=
wej	lwE=
nts	mAE=
tse	mAE=
ldi	mwE=
div	mwE=
ves	mwE=
law	nAE=
awi	nAE=
wi 	nAE=
 ny	nAE=
mex	nQE=
exi	nQE=
xic	nQE=
ico	nQEZIA==
tad	nQE=
nid	nQFF
ido	nQE=
nos	nQE=
lay	ngE=
ays	ngE=
ysi	ngE=
moz	nwE=
oza	nwE=
zam	nwFZ
biq	nwE=
nam	oAENIiI=
mib	oAE=
ibi	oAE=
h w	oAE=
 we	oAE1Hw==
w c	oQE=
cal	oQE=
led	oQE=
nou	oQE=
vel	oQE=
le-	oQE=
e-c	oQE=
-ca	oQE=
nie	oQE=
ie 	oQE=
kan	oQE=
aky	oQE=
nig	ogEC
ige	ogECIQ==
orf	owE=
rfo	owE=
fol	owE=
olk	owE=
lk 	owE=
rag	pQEV
agu	pQEV
ned	pgE=
nde	pgEKEDQ=
orw	pwE=
rwa	pwEZ
way	pwE=
ay 	pwETMA==
y k	pwE=
y n	pwE=
nep	qAE=
epa	qAE=
nau	qQE=
ru 	qQEF
nao	qQE=
aoe	qQE=
lea	qQE=
niu	qgE=
iue	qgE=
w z	qwE=
 ze	qwE=
zea	qwE=
aot	qwE=
tea	qwE=
zee	qwE=
oma	rAEREQ==
sul	rAE=
ult	rAE=
f o	rAE=
 om	rAE=
 um	rAEp
uma	rAER
mus	rAE=
usc	rAE=
cat	rAE=
l z	rQE=
 zo	rQE=
zon	rQE=
eru	rgE=
u p	rgEL
 po	rwEEAwI=
pol	rwEE
oly	rwE9
lyn	rwE=
yne	rwE=
pap	sAE8
apu	sAE=
pua	sAE=
w g	sAE=
dep	sAFE
epe	sAFE
pen	sAFE
phi	sQE=
lip	sQE=
ppi	sQE=
pin	sQE=
e p	sQEG
 ph	sQE=
s p	sQE=
pak	sgE=
aki	sgEY
kis	sgEpEA==
d p	swEe
ols	swE=
lsk	swE=
t p	tAE=
 pi	tAEB
pie	tAE=
miq	tAE=
uel	tAE6
pit	tQE=
itc	tQE=
tca	tQE=
cai	tQEh
irn	tQE=
pue	tgE=
rto	tgE=
to 	tgE=
o b	tgE=
bor	tgE=
riq	tgE=
uen	tgE=
rik	tgE=
ike	tgE=
por	tgECDg==
inq	tgE=
nqu	tgE=
e t	twEqAwg=
rtu	uAE=
l p	uAE=
ugu	uAEy
ues	uAE=
lus	uAE=
usi	uAE=
sit	uAE=
lau	uQEj
pel	uQE=
lew	uQE=
w b	uQE=
uay	ugEw
qat	uwE=
r s	uwEEEw==
f q	uwE=
reu	vAE=
eun	vAE=
urb	vAE=
rbo	vAE=
rom	vQE=
 ro	vQECJQ==
rum	vQE=
oum	vQE=
rbi	vgE=
a y	vgE=
yug	vgE=
ugo	vgE=
gos	vgE=
osl	vgE=
lav	vgE=
srb	vgE=
bij	vgE=
n f	vwEl
a u	vwEmAQ==
 us	vwEpCA==
ssr	vwE=
sr 	vwE=
sov	vwE=
vie	vwEy
t u	vwE=
oss	vwE=
siy	vwE=
iys	vwE=
ysk	vwE=
kay	vwE=
ats	vwE=
tsi	vwE=
nda	wAEnAw==
 rw	wAE=
c t	wAEk
e l	wAEG
lls	wAE=
aud	wQE=
udi	wQE=
abi	wQE0
sol	wgE=
eyc	wwE=
ych	wwE=
 as	xAED
as-	xAE=
s-s	xAE=
-su	xAE=
l-s	xAE=
swe	xQE=
wed	xQE=
sve	xQE=
rig	xQE=
gap	xgE=
apo	xgE=
 ci	xgEm
cit	xgEm
y g	xgE=
t h	xwE=
na,	xwE=
a, 	xwE=
, a	xwE=
sce	xwE=
nsi	xwEw
sio	xwE=
 tr	xwEb
cun	xwE=
unh	xwE=
nha	xwE=
slo	yAEC
lov	yAEC
ove	yAEC
 sl	yAEC
nij	yAE=
sva	yQE=
d j	yQE=
may	yQEt
aye	yQE=
yen	yQE=
vak	ygE=
kia	ygE=
ak 	ygE=
k r	ygE=
nsk	ygE=
sko	ygE=
leo	ywE=
sen	zQE=
ega	zQE=
som	zgE=
sur	zwEF
me 	zwEC
urr	zwE=
m d	zwE=
 to	0QEIBwI=
tom	0QE=
lva	0gE=
vad	0gE=
rte	0wE=
 (d	0wE=
(du	0wE=
syr	1AE=
yri	1AE=
 sy	1AE=
ury	1AE=
rya	1AE=
esw	1QE=
wat	1QE=
i k	1QE=
i s	1QE=
waz	1QE=
ila	1QEF
d u	1QE=
umb	1QE=
bus	1QE=
uso	1QE=
o w	1QE=
tur	1gEIAw==
rks	1gE=
ks 	1gE=
d c	1gE=
cha	1wE=
rie	2AEICg==
tog	2QE=
ogo	2QE=
ole	2QE=
tha	2gE=
 sm	2gE=
smi	2gE=
mil	2gE=
iam	2gE=
taj	2wE=
aji	2wE=
jik	2wE=
tok	3AE=
oke	3AE=
kel	3AE=
u u	3AE=
tim	3QE=
imo	3QE=
or-	3QE=
r-l	3QE=
-le	3QE=
 ti	3QE=
e e	3QE=
t t	3QE=
r e	3QE=
r t	3QE=
r l	3QE=
rkm	3gE=
kme	3gE=
tun	3wEU
ga 	4AE=
ien	4AEK
ndl	4AE=
dly	4AE=
kiy	4QE=
iye	4QE=
ye 	4QE=
rke	4QE=
key	4QE=
ida	4gE=
dad	4gE=
tob	4gE=
oba	4gE=
bag	4gE=
ago	4gE=
alu	4wE=
lu 	4wE=
u e	4wE=
aiw	5AE=
iwa	5AE=
ai-	5AE=
i-u	5AE=
-ua	5AE=
i-o	5AE=
-oa	5AE=
oan	5AE=
 fo	5AE=
for	5AE=
orm	5AE=
rmo	5AE=
mos	5AE=
osa	5AE=
aip	5AE=
pei	5AE=
anz	5QE=
nza	5QE=
zan	5QES
nyi	5QE=
yik	5QE=
ika	5QE=
d z	5QE=
nzi	5QE=
zib	5QE=
ukr	5gE=
kra	5gE=
e u	5gEK
f u	5wEDAQ==
 ug	5wE=
oug	5wE=
arl	5wE=
rl 	5wE=
l o	5wE=
utl	6AE=
tly	6AE=
lyi	6AE=
yin	6AE=
usm	6AE=
smo	6AE=
moi	6AE=
rug	6gE=
y e	6gE=
 ur	6gE=
 or	6gE=
uzb	6wE=
zbe	6wE=
bek	6wE=
eki	6wE=
 uz	6wE=
see	7AE=
ee 	7AE=
vat	7AE=
y p	7AE=
n v	7AEE
t v	7QE=
nez	7gE=
ezu	7gE=
zue	7gE=
iva	7gE=
f v	7gEDAQ==
h v	7wE=
u.s	8AE=
.s.	8AE=
s. 	8AE=
. v	8AE=
s v	8AE=
usv	8AE=
vi 	8AE=
m s	8QE=
m v	8QE=
etn	8QE=
tna	8QE=
van	8gE=
anu	8gE=
nua	8gE=
atu	8gE=
heb	8gE=
ebr	8gE=
rid	8gE=
ide	8gE=
d f	8wE=
 fu	8wE=
fut	8wE=
utu	8wE=
yem	9QE=
eme	9QE=
f y	9QE=
 ye	9QE=
ayo	9gE=
yot	9gE=
ott	9gE=
tte	9gE=
 mz	9wE=
mza	9wE=
f z	+AEB
 rh	+AEB
rho	+AEB
hod	+AEB
imb	+QE=
mba	+QE=
bab	+QE=
abw	+QE=
bwe	+QE=
we 	+QE=
 zi	+QE=
